++++                                        ++++
++++                          #             ++++
++++                          #             ++++
++++                          /             ++++
++++                          #?##          ++++
++++                                        ++++
++++                                        ++++
++++                                    @@  ++++
++++                                  @@@@@@++++
++++                                 @@@@@@@++++
++++                                  @@@@@@++++
++++                                    @$@@++++
++++                                     $  ++++
++++                           _         $  ++++
+++                            ~~~      _$_ ++++
+++                             ++~    ~~~~~++++
+++                                      +++++++
+++         __                            ++++++
+++       ~~~~~~_                          +++++
+++        ++++*~__                         ++++
+++~        **5*+~~~           ~~~           +++
++++         *55*+++            ++~~         +++
++++          ***++                          +++
++++                                         +++
++++                                         +++
++++~                                        +++
+++++~                                      ~+++
++++                                        ++++
+++        ~~                              ~++++
+++        ++~                             +++++
+++        +++~                            +++++
+++        ++++~                           +++++
++                                          ++++
++                    _                      +++
++                   ~~~                      ++
++                   *++__                    ++
++                   **+~~~~                  ++
++                    ****                    ++
++                                __         ~++
++                             __~~~~        +++
++~                            ~~++++       ~+++
+++                           ~++           ++++
+++                                         ++++
+++~                                        ++++
++++                                        ++++
++++                                        ++++
++++~~~~~~~~~~~~~~~~~~~~~~~~~~~~~~~~~~~~~~~~++++
++++++++++++++++++++++++++++++++++++++++++++++++
