+++++++++++++++++++++++++++++++++++++++++++++++++++++++++++++++++++++++++++++++++++++++++++++++++++++++++++++++++++++++++++++++++++++++++++++++++++++++++++++++++++++++++++++++++++++++++++++++++++++++++++++++++++++++++++++++++
+++++++++++++++++++++++++++++++++++++++++++++++++++++++++++++++++++++++++++++++++++++++++++++++++++++++++++++++++++++++++++++++++++++++++++++++++++++++++++++++++++++++++++++++++++++++++++++++++++++++++++++++++++++++++++++++++
+++++++++++++++++++++++++++++++++++++++++++++++++++++++++++++++++++++++++++++++++++++++++++++++++++++++++++++++++++++++++++++++++++++++++++++++++++++++++++++++++++++++++++++++++++++++++++++++++++++++++++++++++++++++++++++++++
+++++++++++++++++++++++++++++++++++++++++++++++++++++++++++++++++++++++++++++++++++++++++++++++++++++++++++++++++++++++++++++++++++++++++++++++++++++++++++++++++++++++++++++++++++++++++++++++++++++++++++++++++++++++++++++++++
+++++++++++++++++++++++++++++++++++++++++++++++++++++++++++++++++++++++++++++++++++++++++++++++++++++++++++++++++++++++++++++++++++++++++++++++++++++++++++++++++++++++++++++++++++++++++++++++++++++++++++++++++++++++++++++++++
+++++++++++++++++++++++++++++++++++++++++++++++++++++++++++++++++++++++++++++++++++++++++++++++++++++++++++++++++++++++++++++++++++++++++++++++++++++++++++++++++++++++++++++++++++++++++++++++++++++++++++++++++++++++++++++++++
+++++++++++++++++++++++++++++++++++++++++++++++++++++++++++++++++++++++++++++++++++++++++++++++++++++++++++++++++++++++++++++++++++++++++++++++++++++++++++++++++++++++++++++++++++++++++++++++++++++++++++++++++++++++++++++++++
+++++++++++++++++++++++++++++++++++++++++++++++++++++++++++++++++++++++++++++++++++++++++++++++++++++++++++++++++++++++++++++++++++++++++++++++++++++++++++++++++++++++++++++++++++++++++++++++++++++++++++++++++++++++++++++++++
+++++++++++++++++++++++++++++++++++++++++++++++++++++++++++++++++++++++++++++++++++++++++++++++++++++++++++++++++++++++++++++++++++++++++++++++++++++++++++++++++++++++++++++++++++++++++++++++++++++++++++++++++++++++++++++++++
+++++++++++++++++++++++++++++++++++++++++++++++++++++++++++++++++++++++++++++++++++++++++++++++++++++++++++++++++++++++++++++++++++++++++++++++++++++++++++++++++++++++++++++++++++++++++++++++++++++++++++++++++++++++++++++++++
+++++++++++++++++++++++++++++++++++++++++++++++++++++++++++++++++++++++++++++++++++++++++++++++++++++++++++++++++++++++++++++++++++++++++++++++++++++++++++++++++++++++++++++++++++++++++++++++++++++++++++++++++++++++++++++++++
+++++++++++++++++++++++++++++++++++++++++++++++++++++++++++++++++++++++++++++++++++++++++++++++++++++++++++++++++++++++++++++++++++++++++++++++++++++++++++++++++++++++++++++++++++++++++++++++++++++++++++++++++++++++++++++++++
+++++++++++++++++++++++++++++++++++++++++++++++++++++++++++++++++++++++++++++++++++++++++++++++++++++++++++++++++++++++++++++++++++++++++++++++++++++++++++++++++++++++++++++++++++++++++++++++++++++++++++++++++++++++++++++++++
+++++++++++++++++++++++++++++++++                                                                                                                                                                 +++++++++++++++++++++++++++++++
+++++++++++++++++++++++++++++                                                                                                                                                                          ++++++++++++++++++++++++++
+++++++++++++++++++++++++++                                                                                                                                                                             +++++++++++++++++++++++++
++++++++++++++++++++++++++                                                            _ _                                                                                                               +++++++++++++++++++++++++
+++++++++++++++++++++++++                                                           _~~~~~~~                                                                                                            +++++++++++++++++++++++++
+++++++++++++++++++++++++                                                          ~~+++++++~_                                                                                                           ++++++++++++++++++++++++
+++++++++++++++++++++++++               &   &                       @@            _++++++++++~_                                                                                                          ++++++++++++++++++++++++
+++++++++++++++++++++++++               &   &                      @@@@         ~~~++*****++++~~_                                                                                                        ++++++++++++++++++++++++
+++++++++++++++++++++++++               &   &                     @@@@@@         ++***555****+++~                                         %%%%%                                                          ++++++++++++++++++++++++
++++++++++++++++++++++++                &   &                     @@@@@@            ****55*****++~     __                                %%%%%%%                                                          +++++++++++++++++++++++
++++++++++++++++++++++++          &&&&&&&&  &                     @@@@@@                 *******      ~~~~_      ___                    %%%%%%%%%                                                         +++++++++++++++++++++++
++++++++++++++++++++++++                &   &                       $@      ~~_            ****        *++~      ~~~~                   %++%%%++%                                                         +++++++++++++++++++++++
++++++++++++++++++++++++                &   &                 ~~~   $        +~                        **+        +++~~~___             %+++%+++%                                                         +++++++++++++++++++++++
++++++++++++++++++++++++                &   &  &               ++~_ $_                                  **         *++++~~~ __          %%%%%%%%%                                                         +++++++++++++++++++++++
++++++++++++++++++++++++                &&     &                ++~~~~~~~~                                          **+++++~~~~          %%%+%%%                                                          +++++++++++++++++++++++
+++++++++++++++++++++++                 &      &                 **++++**                                           ***++++++*            %%%%%                                                          ~+++++++++++++++++++++++
+++++++++++++++++++++++                 &      &                  ******     _                                        *******             % % %                                                          ++++++++++++++++++++++++
+++++++++++++++++++++++          @@     &&&&&&&&&&&&&&&            **       ~~                                         *****                                                                            ~++++++++++++++++++++++++
+++++++++++++++++++++++         @@@@                                                                                                                                                                    +++++++++++++++++++++++++
+++++++++++++++++++++++        @@@@@@                                                                                               ^^^^^^^^^^^^^^^^^                                                   +++++++++++++++++++++++++
+++++++++++++++++++++++        @@@@@@@                                          ~~~~~                                                     ^^^^^                                                         +++++++++++++++++++++++++
++++++++++++++++++++++         @@@@@@@                      ~~~~                    +                                          ~~          ^^^                                                           ++++++++++++++++++++++++
++++++++++++++++++++++          @@$@@                                               +                                                       ^                                                             +++++++++++++++++++++++
++++++++++++++++++++++            $                ~~~~                   ~~~~      +~~~~                               ~~~                 ^                                                              ++++++++++++++++++++++
++++++++++++++++++++++            $                   +         ~~~~                                    @                                                                          # # #                   ++++++++++++++++++++++
++++++++++++++++++++++        ~~~~+~~~                +            +                                 @@@@@@@                                                                       #####                   ++++++++++++++++++++++
++++++++++++++++++++++       ~++++++                  +~~~~~~~     +~  ~~                           @@@@@@@@@      ~                                                               #   #                   ++++++++++++++++++++++
++++++++++++++++++++++      ~+              !|!                        +                   ~~~     @@@@@@@@@@@     +                                                     #         #   #                  ~++++++++++++++++++++++
++++++++++++++++++++++     ~               !!|!!                                                   @@@@@@@@@@@     +                                               # # # ##  #|#####   #                  +++++++++++++++++++++++
++++++++++++++++++++++~                   !!!|!!!               ~~~~               """"             @@@@@@@@@@@    +                                               #######    |        # # # #           ~+++++++++++++++++++++++
+++++++++++++++++++++++                   $  |  $                  +              """"""             @@@$$@@@@@    +                                               #     #    |        #######           +++++++++++++++++++++***
+++++++++++++++++++++++        ~~         &  |  &          ~~~     +            """££""""               $$ @       +                                         # # # #     ###  |              #           ++++++++++++++++++++****
+++++++++++++++++++++++~                  &  |  &                            """"""££"""""              $$                                                   #######          |              #           +++++++++++++++++*******
**++++++++++++++++++++++                  $  |  $                          """""""£££££""""             $$                                                   #                |              #           ++++++++++++++**********
****++++++++++++++++++++         ________ $  |  $                         """""""£££££££"""""      _____$$____                                               #                |              #           +++++++++++++5555*******
****++**+++*++++++++++++~~~~~~~~~~~~~~~~~~~~~~~~~~~~~~~~~~~~~~~~~~~~~~~~~~+""""£££££**££""""+~~~~~~~~~~~++~~~~~~~~~~~~~~~~~~~~~~~~~~~~~~~~~~~~~~~~~~~~~~~~~~~+~~~~~~~~~~~~~~~~~~~~~~~~~~~~~~~+~~~~~~|~~~~+++++++++++*555*********
******22*****++*++++++++++++++++++++++++++++++++++++++++++++++++++++++++++++"""££££***£££""+++++++++++++++++++++++++++++++++++++++++++++++++++++++++++++++++++++++++++++++++++++++++++++++++++++++++|++++++++++++++*55***********
******222**********+++++++++++++++++++++++++++++++++++++++++++++++++++++++++++"""££******"+++++++++++++++++++++++++++++++++++++++++**+++++++++++++++++++++++++++++++++++++++++++++++++++++++++++++++|++++++++***+********11******
*******22*****1********+**++++++++++++++++*++++++*++++***+++**++++*+++++++++++++"****2*5**++++**+++++++++++++++++*+**++++++++++++*555*++++++++++*++++++++**++++++++++++++++++++++++++*+++++++++**+++|++++*+**2**********11*******
**************111*********++++*+++++********+********+*****+******2**++*++***+++****22*5***++****+++++++++*+++***55**+++*+++++++***555*+++++++++**+++++++***++55*+**+*++++**+++**+++***++++++*****++|**+*5****22*****************
********************************5*55********222*******************2********************55**+********+++22*****55555*******+++++**2**55***+++*******++++*22****555555*****2***************++*********|***555****22****************
*******3************************555555******2*********************2********************55*************222**************4**+++*****2************4********22***************2222*********55***22*******|******************33********
******33*****55********************************************11*****22**************************4**5*******************11**********22***4*****************2************************4***55****22*******|******************333*******
*************55555*********4*******************4**********111**************4**33*************4***55*****************1*111********2********** **33****************4******************555************ |***4*****************2******
**************************44*******************4***************4*********************************5******************************  **********     ********************************  5555**********   |****************************
*************************************************************************************************55******************  *     **    *****5***       ******11*******************         *******      |*********1111***************
**********************************************************************************************************4***** *                  ****5555*       ********5**** *********            *******      |*********11*****************
*****************************************************************************************************1*********                         **55**          *   55***  ********       *      **        ******************************
**********************************************************************************************2*******11*******             ******        ******             5         ***    ******              *******************************
**********************************************************************************************2***4****1****555           ************     ****                              **********          ********555*********************
**********************************************************************************************2*************5555        ***55**********           **   **       ****         ***********************22***555*********************
**********************************************************************************************2**************555***222****555***********          ***************22***    ******222****************2222**555*********************
**************************************************************************************************************5***********555********222*************************222************22*************1*****2***555***3*****************
**************************************************************************************************************************55*********22*******************************55*********2*************11********55****33****************
******************************************************************************************************4*******************5********************************************55*************33*****************************************
***************************************************************************************************3**************************************************44**1************55*************3******************************************
***************************************************************************************************33****************1***********3*********************4**11************5********************2***********************************
**********************************************************************************************1*****3********4***22**1************3*************22****************************4**************22**********************************
***********************************************************************************************1*****************2****1*************4**********2222***************************4**************************4******11***************
***********************************************************************************************11****************2*********************11******222*****************************************************4444*****11***************
***************************************************************************************************************************************111**********************33***************************************************************
*********************************************************************************************************************************************************4******333**************************************************************
*********************************************************************************************************************************************************4******333**************************************************************
