+++++++++++++++++++++++++++++++++++++++++++++++++++++++++++++++++++++++++++++++++++++++++++++++++++++++++++++++++++++++++++++++++++++++++++++++++++++++++++++++++++++++++++++++++++++++++++++++++++++++++++++++++++++++++++++++++
+++++++++++++++++++++++++++++++++++++++++++++++++++++++++++++++++++++++++++++++++++++++++++++++++++++++++++++++++++++++++++++++++++++++++++++++++++++++++++++++++++++++++++++++++++++++++++++++++++++++++++++++++++++++++++++++++
+++++++++++++++++++++++++++++++++++++++++++++++++++++++++++++++++++++++++++++++++++++++++++++++++++++++++++++++++++++++++++++++++++++++++++++++++++++++++++++++++++++++++++++++++++++++++++++++++++++++++++++++++++++++++++++++++
+++++++++++++++++++++++++++++++++++++++++++++++++++++++++++++++++++++++++++++++++++++++++++++++++++++++++++++++++++++++++++++++++++++++++++++++++++++++++++++++++++++++++++++++++++++++++++++++++++++++++++++++++++++++++++++++++
+++++++++++++++++++++++++++++++++++++++++++++++++++++++++++++++++++++++++++++++++++++++++++++++++++++++++++++++++++++++++++++++++++++++++++++++++++++++++++++++++++++++++++++++++++++++++++++++++++++++++++++++++++++++++++++++++
+++++++++++++++++++++++++++++++++++++++++++++++++++++++++++++++++++++++++++++++++++++++++++++++++++++++++++++++++++++++++++++++++++++++++++++++++++++++++++++++++++++++++++++++++++++++++++++++++++++++++++++++++++++++++++++++++
+++++++++++++++++++++++++++++++++++++++++++++++++++++++++++++++++++++++++++++++++++++++++++++++++++++++++++++++++++++++++++++++++++++++++++++++++++++++++++++++++++++++++++++++++++++++++++++++++++++++++++++++++++++++++++++++++
+++++++++++++++++++++++++++++++++++++++++++++++++++++++++++++++++++++++++++++++++++++++++++++++++++++++++++++++++++++++++++++++++++++++++++++++++++++++++++++++++++++++++++++++++++++++++++++++++++++++++++++++++++++++++++++++++
+++++++++++++++++++++++++++++++++++++++++++++++++++++++++++++++++++++++++++++++++++++++++++++++++++++++++++++++++++++++++++++++++++++++++++++++++++++++++++++++++++++++++++++++++++++++++++++++++++++++++++++++++++++++++++++++++
+++++++++++++++++++++++++++++++++++++++++++++++++++++++++++++++++++++++++++++++++++++++++++++++++++++++++++++++++++++++++++++++++++++++++++++++++++++++++++++++++++++++++++++++++++++++++++++++++++++++++++++++++++++++++++++++++
+++++++++++++++++++++++++++++++++++++++++++++++++++++++++++++++++++++++++++++++++++++++++++++++++++++++++++++++++++++++++++++++++++++++++++++++++++++++++++++++++++++++++++++++++++++++++++++++++++++++++++++++++++++++++++++++++
+++++++++++++++++++++++++++++++++++++++++++++++++++++++++++++++++++++++++++++++++++++++++++++++++++++++++++++++++++++++++++++++++++++++++++++++++++++++++++++++++++++++++++++++++++++++++++++++++++++++++++++++++++++++++++++++++
+++++++++++++++++++++++###/#####??####?##///####??####??#######/##/###?#####?###///#?#########??#####/#####?###?#####//###/#####??####?##///####??####??#######/##/###?#####?###///#?#########??#####/####+++++++++++++++++++++++
+++++++++++++++++++++++#                                                                                                                                                                                 #+++++++++++++++++++++++
+++++++++++++++++++++++#                                                                                                                                                                                 #+++++++++++++++++++++++
+++++++++++++++++++++++#                                                             ~                                                                                                                   #+++++++++++++++++++++++
+++++++++++++++++++++++#                                                            ~~                                                                                                                   #+++++++++++++++++++++++
+++++++++++++++++++++++#                                                           ~~                                                                                                                    #+++++++++++++++++++++++
+++++++++++++++++++++++#                                                                                                                                                                                 #+++++++++++++++++++++++
+++++++++++++++++++++++#                                                                                                                                                                                 #+++++++++++++++++++++++
+++++++++++++++++++++++#                                                        ~~~                                                                                                                      #+++++++++++++++++++++++
+++++++++++++++++++++++#                                                                                                                                                                                 #+++++++++++++++++++++++
+++++++++++++++++++++++#                                                                                                                                                                                 #+++++++++++++++++++++++
+++++++++++++++++++++++#                                                                                                                                                                                 #+++++++++++++++++++++++
+++++++++++++++++++++++#                                                    ~~                                                                                                                           #+++++++++++++++++++++++
+++++++++++++++++++++++#                                                                                                               %%%     %%%                                                       #+++++++++++++++++++++++
+++++++++++++++++++++++#                                                                                                              %   %   %   %                                                      #+++++++++++++++++++++++
+++++++++++++++++++++++#                                               ~~~                                                             %%%     %%%                                                       #+++++++++++++++++++++++
+++++++++++++++++++++++#                                                                                                                 %%%%%%%                                                         #+++++++++++++++++++++++
+++++++++++++++++++++++#                                                                                                                 % % % %                                                         #+++++++++++++++++++++++
+++++++++++++++++++++++#                                                    ~~                                                            % % %                                                          #+++++++++++++++++++++++
+++++++++++++++++++++++#                                                                                                                                                                                 #+++++++++++++++++++++++
+++++++++++++++++++++++#                                                                                                            ^^^^^^^^^^^^^^^^^                                                    #+++++++++++++++++++++++
+++++++++++++++++++++++#                                                        ~~~                                                       ^^^^^                                                          #+++++++++++++++++++++++
+++++++++++++++++++++++#                                    ~~~~                                                               ~~          ^^^                                                           #+++++++++++++++++++++++
+++++++++++++++++++++++/                   ~~~~~                                            ~~~~~                                           ^                                                            #+++++++++++++++++++++++
+++++++++++++++++++++++#                  ~        ~~~~                   ~~~~      ~~~~~            ~~ ~~  ~~~~        ~~~                 ^                                                            #+++++++++++++++++++++++
+++++++++++++++++++++++#                              +         ~~~~                +   +                                                                                          # # #                 #+++++++++++++++++++++++
+++++++++++++++++++++++?      ~~~                     +            +                +   +                                                                                          #####                 #+++++++++++++++++++++++
+++++++++++++++++++++++?     ~                        +~~~~~~~     +~  ~~      ~~~  +         ~            ~~      ~                                                               #   #                 #+++++++++++++++++++++++
+++++++++++++++++++++++#    ~        ~~~~    ~~~~                      +            +         +~~~         +       +                                                     #         #   #                 #+++++++++++++++++++++++
+++++++++++++++++++++++?   ~                    +                                   +~~~~             ~            +                                               # # # ###########   #                 #+++++++++++++++++++++++
+++++++++++++++++++++++#                        +~~~            ~~~~      ~~~~           ~~~         ~    ~~~~~    +                                               #######             # # # #           #+++++++++++++++++++++++
+++++++++++++++++++++++#                                           +                                ~              +                                               #                   #######           #+++++++++++++++++++++++
+++++++++++++++++++++++/       ~~~~                        ~~~     +                               ~               +                                         # # # #                         #           #+++++++++++++++++++++++
+++++++++++++++++++++++#                  ***  ***                                  "                   $$                                                   #######                         #           #+++++++++++++++++++++++
+++++++++++++++++++++++#                  *      *!                              ""£"""                 $$                                                   #                                           #+++++++++++++++++++++++
+++++++++++++++++++++++#                  *      *!!                           """"£££""                $$                                                   #                                           #+++++++++++++++++++++++
+++++++++++++++++++++++####??########/#####???####?//#######???######//###/###?#####/##?#####//##/#######??###//######??//#??########/#####???####?//#######???######//###/###?#####/##?#####//##/#######?+++++++++++++++++++++++
+++++++++++++++++++++++++++++++++++++++++++++++++++++++++++++++++++++++++++++++++++++++++++++++++++++++++++++++++++++++++++++++++++++++++++++++++++++++++++++++++++++++++++++++++++++++++++++++++++++++++++++++++++++++++++++++++
+++++++++++++++++++++++++++++++++++++++++++++++++++++++++++++++++++++++++++++++++++++++++++++++++++++++++++++++++++++++++++++++++++++++++++++++++++++++++++++++++++++++++++++++++++++++++++++++++++++++++++++++++++++++++++++++++
+++++++++++++++++++++++++++++++++++++++++++++++++++++++++++++++++++++++++++++++++++++++++++++++++++++++++++++++++++++++++++++++++++++++++++++++++++++++++++++++++++++++++++++++++++++++++++++++++++++++++++++++++++++++++++++++++
+++++++++++++++++++++++++++++++++++++++++++++++++++++++++++++++++++++++++++++++++++++++++++++++++++++++++++++++++++++++++++++++++++++++++++++++++++++++++++++++++++++++++++++++++++++++++++++++++++++++++++++++++++++++++++++++++
+++++++++++++++++++++++++++++++++++++++++++++++++++++++++++++++++++++++++++++++++++++++++++++++++++++++++++++++++++++++++++++++++++++++++++++++++++++++++++++++++++++++++++++++++++++++++++++++++++++++++++++++++++++++++++++++++
+++++++++++++++++++++++++++++++++++++++++++++++++++++++++++++++++++++++++++++++++++++++++++++++++++++++++++++++++++++++++++++++++++++++++++++++++++++++++++++++++++++++++++++++++++++++++++++++++++++++++++++++++++++++++++++++++
+++++++++++++++++++++++++++++++++++++++++++++++++++++++++++++++++++++++++++++++++++++++++++++++++++++++++++++++++++++++++++++++++++++++++++++++++++++++++++++++++++++++++++++++++++++++++++++++++++++++++++++++++++++++++++++++++
+++++++++++++++++++++++++++++++++++++++++++++++++++++++++++++++++++++++++++++++++++++++++++++++++++++++++++++++++++++++++++++++++++++++++++++++++++++++++++++++++++++++++++++++++++++++++++++++++++++++++++++++++++++++++++++++++
+++++++++++++++++++++++++++++++++++++++++++++++++++++++++++++++++++++++++++++++++++++++++++++++++++++++++++++++++++++++++++++++++++++++++++++++++++++++++++++++++++++++++++++++++++++++++++++++++++++++++++++++++++++++++++++++++
+++++++++++++++++++++++++++++++++++++++++++++++++++++++++++++++++++++++++++++++++++++++++++++++++++++++++++++++++++++++++++++++++++++++++++++++++++++++++++++++++++++++++++++++++++++++++++++++++++++++++++++++++++++++++++++++++
+++++++++++++++++++++++++++++++++++++++++++++++++++++++++++++++++++++++++++++++++++++++++++++++++++++++++++++++++++++++++++++++++++++++++++++++++++++++++++++++++++++++++++++++++++++++++++++++++++++++++++++++++++++++++++++++++
+++++++++++++++++++++++++++++++++++++++++++++++++++++++++++++++++++++++++++++++++++++++++++++++++++++++++++++++++++++++++++++++++++++++++++++++++++++++++++++++++++++++++++++++++++++++++++++++++++++++++++++++++++++++++++++++++
