###/#####??####?##///####??####??#######/##/###?#####?###///#?#########??#####/#####?###?#####//###/#####??####?##///####??####??#######/##/###?#####?###///#?#########??#####/#####?###?########/#####??####?##///####??####??#######/##/###?#####?###///#?#########??#####/#####?###?#####//###/#####??####?##///####??####??#######/##/###?#####?###///#?#########??#####/#####?###?###
#                                                                                                                                                                                                                                                                                                                                                                                        #
#                                                                                                                                                                                                                                                                                                                                                                                        #
#                                                                                                                                                                                                                                                                                                                                                                                        #
#                                                                                                                                                                                                                                                                                                                                                                                        #
#                                                                                                                                                                                                                                                                                                                                                                                        #
#                                                                                                                                                                                                                                                                                                                                                                                        #
#                                                                                                                                                                                                                                                                                                                                                                                        #
#                                                        ~~~                                                                                                                                                                                                                                                                                                                             #
#                                                                                                                                                                                                                                                                                                                                                                                        #
#                                                                                                                                                                                                                                                                                                                                                                                        #
#                                                    ~~                                                                                                                                                                                                                                                                                                                                  #
#                                                                                                               %%%     %%%                                                                                                                                                                                                                                                              #
#                                                                                                              %   %   %   %                                                                                                                                                                                                                                                             #
#                                               ~~~                                                             %%%     %%%                                                                                                                                                                                                                                                              #
#                                                                                                                 %%%%%%%                                                                                                                                                                                                                                                                #
#                                                                                                                 % % % %                                                                                                                                                                                                                                                                #
#                                                    ~~                                                            % % %                                                                                                                                                                                                                                                                 #
#                                                                                                                                                                                                                                                                                                                                                                                        #
#                                                                                                            ^^^^^^^^^^^^^^^^^                                                                                                                                                                                                                                                           #
#                                                        ~~~                                                       ^^^^^                                                                                                                                                                                                                                                                 #
#                                    ~~~~                                                                           ^^^                                                                                                                                                                                                                                                                  #
/                   ~~~~~                                            ~~~~~                                           ^                                                                                                                                                                                                                                                                   #
#                  ~        ~~~~                   ~~~~      ~~~~~            ~~ ~~  ~~~~                            ^                                                                                                                                                                                                                                                                   #
#                              +         ~~~~                +   +                                                                                          # # #                                                                                                                                                                                                                        #
?      ~~~                     +            +                +   +                                                                                          #####                                                                                                                                                                                                                        #
?     ~                        +~~~~~~~     +~  ~~      ~~~  +         ~            ~~      ~                                                               #   #                                                                                                                                                                                                                        #
#    ~        ~~~~    ~~~~                      +            +         +~~~         +       +                                                     #         #   #                                                                                                                                                                                                                        #
?   ~                    +                                   +~~~~             ~            +                                               # # # ###########   #                                                                                                                                                                                                                        #
#                        +~~~            ~~~~      ~~~~           ~~~         ~    ~~~~~    +                                               #######             # # # #                                                                                                                                                                                                                  #
#                                           +          ~~~~                  ~              +                                               #                   #######                                                                                                                                                                                                                  #
/       ~~~~                        ~~~     +                               ~               +                                         # # # #                         #                                                                                                                                                                                                                  #
#                  ***  ***                                  "                   $$                                                   #######                         #                                                                                                                                                                                                                  #
#                  *      *!                              ""£"""                 $$                                                   #                                                                                                                                                                                                                                                  #
#                  *      *!!                           """"£££""                $$                                                   #                                                                                                                                                                                                                                                  #
??########/#####???####?//#######???######//###/###?#####/##?#####//##/#######??###//######??//#??########/#####???####?//#######???######//###/###?#####/##?#####//##/#######??###//######??/??########/#####???####?//#######???######//###/###?#####/##?#####//##/#######??###//######??//#??########/#####???####?//#######???######//###/###?#####/##?#####//##/#######??###//######?
