+++++++++++++++++++++++++++++++++++++++++++++++++++++++++++++++++++++++++++++++++++++++++++++++++++++++++++++++++++++++++++++++++++++++++++++++++++++++++++++++++++++++++++++++++++++++++++++++++++++++++++++++++++++++++++++++++
+++++++++++++++++++++++++++++++++++++++++++++++++++++++++++++++++++++++++++++++++++++++++++++++++++++++++++++++++++++++++++++++++++++++++++++++++++++++++++++++++++++++++++++++++++++++++++++++++++++++++++++++++++++++++++++++++
+++++++++++++++++++++++++++++++++++++++++++++++++++++++++++++++++++++++++++++++++++++++++++++++++++++++++++++++++++++++++++++++++++++++++++++++++++++++++++++++++++++++++++++++++++++++++++++++++++++++++++++++++++++++++++++++++
+++++++++++++++++++++++++++++++++++++++++++++++++++++++++++++++++++++++++++++++++++++++++++++++++++++++++++++++++++++++++++++++++++++++++++++++++++++++++++++++++++++++++++++++++++++++++++++++++++++++++++++++++++++++++++++++++
+++++++++++++++++++++++++++++++++++++++++++++++++++++++++++++++++++++++++++++++++++++++++++++++++++++++++++++++++++++++++++++++++++++++++++++++++++++++++++++++++++++++++++++++++++++++++++++++++++++++++++++++++++++++++++++++++
+++++++++++++++++++++++++++++++++++++++++++++++++++++++++++++++++++++++++++++++++++++++++++++++++++++++++++++++++++++++++++++++++++++++++++++++++++++++++++++++++++++++++++++++++++++++++++++++++++++++++++++++++++++++++++++++++
+++++++++++++++++++++++++++++++++++++++++++++++++++++++++++++++++++++++++++++++++++++++++++++++++++++++++++++++++++++++++++++++++++++++++++++++++++++++++++++++++++++++++++++++++++++++++++++++++++++++++++++++++++++++++++++++++
+++++++++++++++++++++++++++++++++++++++++++++++++++++++++++++++++++++++++++++++++++++++++++++++++++++++++++++++++++++++++++++++++++++++++++++++++++++++++++++++++++++++++++++++++++++++++++++++++++++++++++++++++++++++++++++++++
+++++++++++++++++++++++++++++++++++++++++++++++++++++++++++++++++++++++++++++++++++++++++++++++++++++++++++++++++++++++++++++++++++++++++++++++++++++++++++++++++++++++++++++++++++++++++++++++++++++++++++++++++++++++++++++++++
+++++++++++++++++++++++++++++++++++++++++++++++++++++++++++++++++++++++++++++++++++++++++++++++++++++++++++++++++++++++++++++++++++++++++++++++++++++++++++++++++++++++++++++++++++++++++++++++++++++++++++++++++++++++++++++++++
+++++++++++++++++++++++++++++++++++++++++++++++++++++++++++++++++++++++++++++++++++++++++++++++++++++++++++++++++++++++++++++++++++++++++++++++++++++++++++++++++++++++++++++++++++++++++++++++++++++++++++++++++++++++++++++++++
+++++++++++++++++++++++++++++++++++++++++++++++++++++++++++++++++++++++++++++++++++++++++++++++++++++++++++++++++++++++++++++++++++++++++++++++++++++++++++++++++++++++++++++++++++++++++++++++++++++++++++++++++++++++++++++++++
+++++++++++++++++++++++###/#####??####?##///####??####??#######/##/###?#####?###///#?#########??#####/#####?###?#####//###/#####??####?##///####??####??#######/##/###?#####?###///#?#########??#####/####+++++++++++++++++++++++
+++++++++++++++++++++++#                                                                                                                                                                                 #+++++++++++++++++++++++
+++++++++++++++++++++++#                                                                                                                                                                                 #+++++++++++++++++++++++
+++++++++++++++++++++++#                                                             ~                                                                                                                   #+++++++++++++++++++++++
+++++++++++++++++++++++#                                                            ~~                                                                                                                   #+++++++++++++++++++++++
+++++++++++++++++++++++#                                                           ~~                                                                                                                    #+++++++++++++++++++++++
+++++++++++++++++++++++#                                                                                                                                                                                 #+++++++++++++++++++++++
+++++++++++++++++++++++#                                                                                                                                                                                 #+++++++++++++++++++++++
+++++++++++++++++++++++#                                                        ~~~                                                                                                                      #+++++++++++++++++++++++
+++++++++++++++++++++++#                                                                                                                  %%%%%                                                          #+++++++++++++++++++++++
+++++++++++++++++++++++#                                                                                                                 %%%%%%%                                                         #+++++++++++++++++++++++
+++++++++++++++++++++++#                                                                                                                %%%%%%%%%                                                        #+++++++++++++++++++++++
+++++++++++++++++++++++#                                                    ~~                                                          %++%%%++%                                                        #+++++++++++++++++++++++
+++++++++++++++++++++++#                                                                                                                %+++%+++%                                                        #+++++++++++++++++++++++
+++++++++++++++++++++++#                                                                                                                %%%%%%%%%                                                        #+++++++++++++++++++++++
+++++++++++++++++++++++#                                               ~~~                                                               %%%+%%%                                                         #+++++++++++++++++++++++
+++++++++++++++++++++++#                                                                                                                  %%%%%                                                          #+++++++++++++++++++++++
+++++++++++++++++++++++#                                                                                                                  % % %                                                          #+++++++++++++++++++++++
+++++++++++++++++++++++#                                                    ~~                                                                                                                           #+++++++++++++++++++++++
+++++++++++++++++++++++#                                                                                                                                                                                 #+++++++++++++++++++++++
+++++++++++++++++++++++#                                                                                                            ^^^^^^^^^^^^^^^^^                                                    #+++++++++++++++++++++++
+++++++++++++++++++++++#                                                        ~~~~~                                                     ^^^^^                                                          #+++++++++++++++++++++++
+++++++++++++++++++++++#                                    ~~~~                    +                                          ~~          ^^^                                                           #+++++++++++++++++++++++
+++++++++++++++++++++++/                                                            +                                                       ^                                                            #+++++++++++++++++++++++
+++++++++++++++++++++++#                           ~~~~                   ~~~~      +~~~~                               ~~~                 ^                                                            #+++++++++++++++++++++++
+++++++++++++++++++++++#                              +         ~~~~                                    #                                                                          # # #                 #+++++++++++++++++++++++
+++++++++++++++++++++++?      ~~~                     +            +                                 /##?###                                                                       #####                 #+++++++++++++++++++++++
+++++++++++++++++++++++?     ~               !        +~~~~~~~     +~  ~~                           ?##?/??##      ~                                                               #   #                 #+++++++++++++++++++++++
+++++++++++++++++++++++#    ~               !!!                        +                   ~~~     #####?#/?/#     +                                                     #         #   #                 #+++++++++++++++++++++++
+++++++++++++++++++++++?   ~               !!!!!                                                   //?#?/#?/??     +                                               # # # ###########   #                 #+++++++++++++++++++++++
+++++++++++++++++++++++#                  !!!!!!!               ~~~~      ~~~      """"             ?#?//##??/#    +                                               #######             # # # #           #+++++++++++++++++++++++
+++++++++++++++++++++++#                  $     $                  +              """"""             ##/$$#/?##    +                                               #                   #######           #+++++++++++++++++++++++
+++++++++++++++++++++++/       ~~         $     $          ~~~     +            """££""""               $$ ?       +                                         # # # #                         #           #+++++++++++++++++++++++
+++++++++++++++++++++++#                  $     $                            """"""££"""""              $$                                                   #######                         #           #+++++++++++++++++++++++
+++++++++++++++++++++++#                  $     $                          """""""£££££""""             $$                                                   #                                           #+++++++++++++++++++++++
+++++++++++++++++++++++#                  $     $                         """""""£££££££"""""           $$                                                   #                                           #+++++++++++++++++++++++
+++++++++++++++++++++++####??########/#####???####?//#######???######//###/###?#####/##?/####//##/#######??###//######??//#??########/#####???####?//#######???######//###/###?#####/##?#####//##/#######?+++++++++++++++++++++++
+++++++++++++++++++++++++++++++++++++++++++++++++++++++++++++++++++++++++++++++++++++++++++++++++++++++++++++++++++++++++++++++++++++++++++++++++++++++++++++++++++++++++++++++++++++++++++++++++++++++++++++++++++++++++++++++++
+++++++++++++++++++++++++++++++++++++++++++++++++++++++++++++++++++++++++++++++++++++++++++++++++++++++++++++++++++++++++++++++++++++++++++++++++++++++++++++++++++++++++++++++++++++++++++++++++++++++++++++++++++++++++++++++++
+++++++++++++++++++++++++++++++++++++++++++++++++++++++++++++++++++++++++++++++++++++++++++++++++++++++++++++++++++++++++++++++++++++++++++++++++++++++++++++++++++++++++++++++++++++++++++++++++++++++++++++++++++£++£££+£++++++
+++++++++++++++++++++++++++++++++++++++++++++++++++++++++++++++++++++++++++++++++++++++++++++++++++++++++++++++++++++++++++++++++++++++++++++++++++++++++++++++++++++++++++++++++++++++++++++++++++++++++++++++++++£++£+£+£++++++
+++++++++++++++++++++++++++++++++++++++++++++++++++++++++++++++++++++++++++++++++++++++++++++++++++++++++++++++++++++++++++++++++++++++++++++++++++++++++++++++++++++++++++++++++++++++++++++++++++++++++++++++++++££+£££+££+++++
+++++++++++++++++++++++++++++++++++++++++++++++++++++++++++++++++++++++++++++++++++++++++++++++++++++++++++++++++++++++++++++++++++++++++++++++++++++++++++++++++++++++++++++++++++++++++++++++++++++++++++++++++++++++++++++++++
+++++++++++++++++++++++++++++++++++++++++++++++++++++++++++++++++++++++++++++++++++++++++++++++++++++++++++++++++++++++++++++++++++++++++++++++++++++++++++++++++++++++++++++++++++++++++++++++++++++++++++++++++++++++++++++++++
+++++++++++++++++++++++++++++++++++++++++++++++++++++++++++++++++++++++++++++++++++++++++++++++++++++++++++++++++++++++++++++++++++++++++++++++++++++++++++++++++++++++++++++++++++++++++++++++++++++++++++++++++++++++++++++++++
+++++++++++++++++++++++++++++++++++++++++++++++++++++++++++++++++++++++++++++++++++++++++++++++++++++++++++++++++++++++++++++++++++++++++++++++++++++++++++++++++++++++++++++++++++++++++++++++++++++++++++++++++++++++++++++++++
+++++++++++++++++++++++++++++++++++++++++++++++++++++++++++++++++++++++++++++++++++++++++++++++++++++++++++++++++++++++++++++++++++++++++++++++++++++++++++++++++++++++++++++++++++++++++++++++++++++++++++++++++++++++++++++++++
+++++++++++++++++++++++++++++++++++++++++++++++++++++++++++++++++++++++++++++++++++++++++++++++++++++++++++++++++++++++++++++++++++++++++++++++++++++++++++++++++++++++++++++++++++++++++++++++++++++++++++++++++++++++++++++++++
+++++++++++++++++++++++++++++++++++++++++++++++++++++++++++++++++++++++++++++++++++++++++++++++++++++++++++++++++++++++++++++++++++++++++++++++++++++++++++++++++++++++++++++++++++++++++++++++++++++++++++++++++++++++++++++++++
