###/#####??####?##///####??####??#######/##/###?#####?###///#?#########??#####/#####?###?#####//
#                                                                                              #
#                                                                                              #
#                                    ~~~~                                                      /
/                   ~~~~~                                            ~~~~~                     #
#                  ~        ~~~~                   ~~~~      ~~~~~            ~~ ~~  ~~~~      /
#                              +         ~~~~                +   +                             ?
?      ~~~                     +            +                +   +                             /
?     ~                        +~~~~~~~     +~  ~~      ~~~  +         ~            ~~      ~  /
#    ~        ~~~~    ~~~~                      +            +         +~~~         +       +  ?
?   ~                    +                                   +~~~~             ~            +  #
#                        +~~~            ~~~~      ~~~            ~~~         ~    ~~~~~    +  #
#                                           +            ~~                  ~              +  #
/       ~~~~                        ~~~     +                               ~    $$         +  ?
#                  ***  ***                                  "                   $$            /
#                  *      *!                              ""£"""                 $$            #
#                  *      *!!                           """"£££""                $$            #
??########/#####???####?//#######???######//###/###?#####/##?#####//##/#######??###//######??//#
