###/#####??####?##///####??####??#######/##/###?#####?###///#?#########??#####/#####?###?#####//
#                                                                                              #
#                                                                                              #
#                                    ~~~~                                                      /
/                   ~~~~~                                            ~~~~~                     #
#                  ~        ~~~~                   ~~~~      ~~~~~            ~~ ~~  ~~~~      /
#                              ~         ~~~~                ~   ~                             ?
?      ~~~                     ~            ~                ~   ~                             /
?     ~                        ~~~~~~~~     ~~  ~~      ~~~  ~         ~            ~~      ~  /
#    ~        ~~~~    ~~~~                      ~            ~         ~~~~         ~       ~  ?
?   ~                    ~                                   ~~~~~             ~            ~  #
#                        ~~~~            ~~~~      ~~~            ~~~         ~    ~~~~~    ~  #
#                        ~                  ~            ~~                  ~              ~  #
/       ~~~~             ~          ~~~     ~             ~                 ~               ~  ?
#                                                                                              /
#                                                                                              #
#                                                                                              #
??########/#####???####?//#######???######//###/###?#####/##?#####//##/#######??###//######??//#
